1111111
111PCE      1
111111      1